[console_scripts]
calibrate-orientation = piwardrive.scripts.calibrate_orientation:main
check-orientation-sensors = piwardrive.scripts.check_orientation_sensors:main
config-cli = piwardrive.scripts.config_cli:main
db-summary = piwardrive.scripts.db_summary:main
export-gpx = piwardrive.scripts.export_gpx:main
export-grafana = piwardrive.scripts.export_grafana:main
export-log-bundle = piwardrive.scripts.export_log_bundle:main
export-orientation-map = piwardrive.scripts.export_orientation_map:main
export-shp = piwardrive.scripts.export_shp:main
health-export = piwardrive.scripts.health_export:main
health-import = piwardrive.scripts.health_import:main
health-stats = piwardrive.scripts.health_stats:main
log-follow = piwardrive.scripts.log_follow:main
piwardrive-deps-audit = piwardrive.scripts.dependency_audit:main
piwardrive-field-diagnostics = piwardrive.scripts.field_diagnostics:main
piwardrive-field-status = piwardrive.scripts.field_status_indicators:main
piwardrive-install = piwardrive.scripts.install_cli:main
piwardrive-kiosk = piwardrive.cli.kiosk:main
piwardrive-maintain-tiles = piwardrive.scripts.tile_maintenance_cli:main
piwardrive-mbtiles = piwardrive.scripts.vector_tile_customizer_cli:main
piwardrive-migrate = piwardrive.scripts.migrate_db:main
piwardrive-mobile-diagnostics = piwardrive.scripts.mobile_diagnostics:main
piwardrive-prefetch = piwardrive.scripts.prefetch_cli:main
piwardrive-prefetch-batch = piwardrive.scripts.prefetch_batch:main
piwardrive-problem-reporter = piwardrive.scripts.problem_reporter:main
piwardrive-service = piwardrive.service:main
piwardrive-vacuum = piwardrive.scripts.vacuum_db:main
piwardrive-webui = piwardrive.webui_server:main
prune-db = piwardrive.scripts.prune_db:main
scan-report = piwardrive.scripts.scan_report:main
service-status = piwardrive.scripts.service_status:main
uav-record = piwardrive.scripts.uav_record:main
uav-track-playback = piwardrive.scripts.uav_track_playback:main
